абонемент — абонент
абстрактность — абстракция
авантюрин — авантюрист
автобиографический — автобиографичный
автоматический — автоматичный
адресант — адресат
академический — академичный
аккордный — аккордовый
бабий — бабский
барский — барственный
бедный — бедственный
безделица — бездельница
безликий — безличный
безответный — безответственный
безыскусный — безыскусственный
белеть — белить
вакансия — вакация
вакхальный — вакханальный
варкий — варочный
вассальный — вассальский
вафельница — вафельщица
вбежать — взбежать
вбить — взбить
ввалить — взвалить
гагарий — гагаровый
гадальный — гадательный
гарантийный — гарантированный
дарёный — даровой
дармоедный — дармоедский
двигатель — движитель